Narrátor	Kecskés Tímea
József	Cservenák Vilmos
Jákob	Simor Ottó
Rúben	Domoszlai Sándor
Simeon	Tokaji Csaba
Júda	Szente Vajk
Benjámin	Ale Bence, Ale Dávid
Gád	Hajdú Péter
Lévi	Vranyecz Artúr
Náftáli	Révész Béla
Iszákár	Juhász Árpád
Asher	Baranyi Péter
Dán	Kéri Nagy Béla
Zebulon	Steuer Tibor
Putifár	Böjte Sándor
Putifárné	Linda Schneiderova, Gabriela Zarubova
Fáraó	Csutka István
Pék	Sinai Tibor
Fõpohárnok	Kerékgyártó Csaba
Apache táncosnõ	Perez Agurtzane, Bogdan Petronella
Díszlet-jelmeztervezõ: Kentaur 
Irodalmi munkatárs: Töreki Attila 
Koreográfus: Egerházi Attila 
Hangszerelés: Dobsa Sándor és Kalmus Pál 
Mozgás: Halász G. Péter 
Korrepetítor: Kubik József 
Karigazgató: Pálinkás Péter 
Világítás-tervezõ: Fürtös 
Súgó: Kató Anikó
Rendezõasszisztens: Hencz József, Laczó Zuszsa
Ügyelõ: Tenki Ferenc 
Visual effect: PHILOVISION 
Rendezõ: Csutka István

